8 8
#......#
..#..#..
...#....
..#...#.
#..#G#..
..###...
..S#.#..
#......#
